yearID,lgID,teamID,G,W,L,R,RA,RD,Wpct
2000,AL,ANA,162,82,80,864,869,-5,0.50617284
2000,NL,ARI,162,85,77,792,754,38,0.524691358
2000,NL,ATL,162,95,67,810,714,96,0.586419753
2000,AL,BAL,162,74,88,794,913,-119,0.456790123
2000,AL,BOS,162,85,77,792,745,47,0.524691358
2000,AL,CHA,162,95,67,978,839,139,0.586419753
2000,NL,CHN,162,65,97,764,904,-140,0.401234568
2000,NL,CIN,163,85,77,825,765,60,0.524691358
2000,AL,CLE,162,90,72,950,816,134,0.555555556
2000,NL,COL,162,82,80,968,897,71,0.50617284
2000,AL,DET,162,79,83,823,827,-4,0.487654321
2000,NL,FLO,161,79,82,731,797,-66,0.49068323
2000,NL,HOU,162,72,90,938,944,-6,0.444444444
2000,AL,KCA,162,77,85,879,930,-51,0.475308642
2000,NL,LAN,162,86,76,798,729,69,0.530864198
2000,NL,MIL,163,73,89,740,826,-86,0.450617284
2000,AL,MIN,162,69,93,748,880,-132,0.425925926
2000,NL,MON,162,67,95,738,902,-164,0.413580247
2000,AL,NYA,161,87,74,871,814,57,0.540372671
2000,NL,NYN,162,94,68,807,738,69,0.580246914
2000,AL,OAK,161,91,70,947,813,134,0.565217391
2000,NL,PHI,162,65,97,708,830,-122,0.401234568
2000,NL,PIT,162,69,93,793,888,-95,0.425925926
2000,NL,SDN,162,76,86,752,815,-63,0.469135802
2000,AL,SEA,162,91,71,907,780,127,0.561728395
2000,NL,SFN,162,97,65,925,747,178,0.598765432
2000,NL,SLN,162,95,67,887,771,116,0.586419753
2000,AL,TBA,161,69,92,733,842,-109,0.428571429
2000,AL,TEX,162,71,91,848,974,-126,0.438271605
2000,AL,TOR,162,83,79,861,908,-47,0.512345679
2001,AL,ANA,162,75,87,691,730,-39,0.462962963
2001,NL,ARI,162,92,70,818,677,141,0.567901235
2001,NL,ATL,162,88,74,729,643,86,0.543209877
2001,AL,BAL,162,63,98,687,829,-142,0.391304348
2001,AL,BOS,161,82,79,772,745,27,0.50931677
2001,AL,CHA,162,83,79,798,795,3,0.512345679
2001,NL,CHN,162,88,74,777,701,76,0.543209877
2001,NL,CIN,162,66,96,735,850,-115,0.407407407
2001,AL,CLE,162,91,71,897,821,76,0.561728395
2001,NL,COL,162,73,89,923,906,17,0.450617284
2001,AL,DET,162,66,96,724,876,-152,0.407407407
2001,NL,FLO,162,76,86,742,744,-2,0.469135802
2001,NL,HOU,162,93,69,847,769,78,0.574074074
2001,AL,KCA,162,65,97,729,858,-129,0.401234568
2001,NL,LAN,162,86,76,758,744,14,0.530864198
2001,NL,MIL,162,68,94,740,806,-66,0.419753086
2001,AL,MIN,162,85,77,771,766,5,0.524691358
2001,NL,MON,162,68,94,670,812,-142,0.419753086
2001,AL,NYA,161,95,65,804,713,91,0.59375
2001,NL,NYN,162,82,80,642,713,-71,0.50617284
2001,AL,OAK,162,102,60,884,645,239,0.62962963
2001,NL,PHI,162,86,76,746,719,27,0.530864198
2001,NL,PIT,162,62,100,657,858,-201,0.382716049
2001,NL,SDN,162,79,83,789,812,-23,0.487654321
2001,AL,SEA,162,116,46,927,627,300,0.716049383
2001,NL,SFN,162,90,72,799,748,51,0.555555556
2001,NL,SLN,162,93,69,814,684,130,0.574074074
2001,AL,TBA,162,62,100,672,887,-215,0.382716049
2001,AL,TEX,162,73,89,890,968,-78,0.450617284
2001,AL,TOR,162,80,82,767,753,14,0.49382716
2002,AL,ANA,162,99,63,851,644,207,0.611111111
2002,NL,ARI,162,98,64,819,674,145,0.604938272
2002,NL,ATL,161,101,59,708,565,143,0.63125
2002,AL,BAL,162,67,95,667,773,-106,0.413580247
2002,AL,BOS,162,93,69,859,665,194,0.574074074
2002,AL,CHA,162,81,81,856,798,58,0.5
2002,NL,CHN,162,67,95,706,759,-53,0.413580247
2002,NL,CIN,162,78,84,709,774,-65,0.481481481
2002,AL,CLE,162,74,88,739,837,-98,0.456790123
2002,NL,COL,162,73,89,778,898,-120,0.450617284
2002,AL,DET,161,55,106,575,864,-289,0.341614907
2002,NL,FLO,162,79,83,699,763,-64,0.487654321
2002,NL,HOU,162,84,78,749,695,54,0.518518519
2002,AL,KCA,162,62,100,737,891,-154,0.382716049
2002,NL,LAN,162,92,70,713,643,70,0.567901235
2002,NL,MIL,162,56,106,627,821,-194,0.345679012
2002,AL,MIN,161,94,67,768,712,56,0.583850932
2002,NL,MON,162,83,79,735,718,17,0.512345679
2002,AL,NYA,161,103,58,897,697,200,0.639751553
2002,NL,NYN,161,75,86,690,703,-13,0.465838509
2002,AL,OAK,162,103,59,800,654,146,0.635802469
2002,NL,PHI,161,80,81,710,724,-14,0.49689441
2002,NL,PIT,161,72,89,641,730,-89,0.447204969
2002,NL,SDN,162,66,96,662,815,-153,0.407407407
2002,AL,SEA,162,93,69,814,699,115,0.574074074
2002,NL,SFN,162,95,66,783,616,167,0.590062112
2002,NL,SLN,162,97,65,787,648,139,0.598765432
2002,AL,TBA,161,55,106,673,918,-245,0.341614907
2002,AL,TEX,162,72,90,843,882,-39,0.444444444
2002,AL,TOR,162,78,84,813,828,-15,0.481481481
2003,AL,ANA,162,77,85,736,743,-7,0.475308642
2003,NL,ARI,162,84,78,717,685,32,0.518518519
2003,NL,ATL,162,101,61,907,740,167,0.62345679
2003,AL,BAL,163,71,91,743,820,-77,0.438271605
2003,AL,BOS,162,95,67,961,809,152,0.586419753
2003,AL,CHA,162,86,76,791,715,76,0.530864198
2003,NL,CHN,162,88,74,724,683,41,0.543209877
2003,NL,CIN,162,69,93,694,886,-192,0.425925926
2003,AL,CLE,162,68,94,699,778,-79,0.419753086
2003,NL,COL,162,74,88,853,892,-39,0.456790123
2003,AL,DET,162,43,119,591,928,-337,0.265432099
2003,NL,FLO,162,91,71,751,692,59,0.561728395
2003,NL,HOU,162,87,75,805,677,128,0.537037037
2003,AL,KCA,162,83,79,836,867,-31,0.512345679
2003,NL,LAN,162,85,77,574,556,18,0.524691358
2003,NL,MIL,162,68,94,714,873,-159,0.419753086
2003,AL,MIN,162,90,72,801,758,43,0.555555556
2003,NL,MON,162,83,79,711,716,-5,0.512345679
2003,AL,NYA,163,101,61,877,716,161,0.62345679
2003,NL,NYN,161,66,95,642,754,-112,0.409937888
2003,AL,OAK,162,96,66,768,643,125,0.592592593
2003,NL,PHI,162,86,76,791,697,94,0.530864198
2003,NL,PIT,162,75,87,753,801,-48,0.462962963
2003,NL,SDN,162,64,98,678,831,-153,0.395061728
2003,AL,SEA,162,93,69,795,637,158,0.574074074
2003,NL,SFN,161,100,61,755,638,117,0.621118012
2003,NL,SLN,162,85,77,876,796,80,0.524691358
2003,AL,TBA,162,63,99,715,852,-137,0.388888889
2003,AL,TEX,162,71,91,826,969,-143,0.438271605
2003,AL,TOR,162,86,76,894,826,68,0.530864198
2004,AL,ANA,162,92,70,836,734,102,0.567901235
2004,NL,ARI,162,51,111,615,899,-284,0.314814815
2004,NL,ATL,162,96,66,803,668,135,0.592592593
2004,AL,BAL,162,78,84,842,830,12,0.481481481
2004,AL,BOS,162,98,64,949,768,181,0.604938272
2004,AL,CHA,162,83,79,865,831,34,0.512345679
2004,NL,CHN,162,89,73,789,665,124,0.549382716
2004,NL,CIN,162,76,86,750,907,-157,0.469135802
2004,AL,CLE,162,80,82,858,857,1,0.49382716
2004,NL,COL,162,68,94,833,923,-90,0.419753086
2004,AL,DET,162,72,90,827,844,-17,0.444444444
2004,NL,FLO,162,83,79,718,700,18,0.512345679
2004,NL,HOU,162,92,70,803,698,105,0.567901235
2004,AL,KCA,162,58,104,720,905,-185,0.358024691
2004,NL,LAN,162,93,69,761,684,77,0.574074074
2004,NL,MIL,161,67,94,634,757,-123,0.416149068
2004,AL,MIN,162,92,70,780,715,65,0.567901235
2004,NL,MON,162,67,95,635,769,-134,0.413580247
2004,AL,NYA,162,101,61,897,808,89,0.62345679
2004,NL,NYN,162,71,91,684,731,-47,0.438271605
2004,AL,OAK,162,91,71,793,742,51,0.561728395
2004,NL,PHI,162,86,76,840,781,59,0.530864198
2004,NL,PIT,161,72,89,680,744,-64,0.447204969
2004,NL,SDN,162,87,75,768,705,63,0.537037037
2004,AL,SEA,162,63,99,698,823,-125,0.388888889
2004,NL,SFN,162,91,71,850,770,80,0.561728395
2004,NL,SLN,162,105,57,855,659,196,0.648148148
2004,AL,TBA,161,70,91,714,842,-128,0.434782609
2004,AL,TEX,162,89,73,860,794,66,0.549382716
2004,AL,TOR,161,67,94,719,823,-104,0.416149068
2005,NL,ARI,162,77,85,696,856,-160,0.475308642
2005,NL,ATL,162,90,72,769,674,95,0.555555556
2005,AL,BAL,162,74,88,729,800,-71,0.456790123
2005,AL,BOS,162,95,67,910,805,105,0.586419753
2005,AL,CHA,162,99,63,741,645,96,0.611111111
2005,NL,CHN,162,79,83,703,714,-11,0.487654321
2005,NL,CIN,163,73,89,820,889,-69,0.450617284
2005,AL,CLE,162,93,69,790,642,148,0.574074074
2005,NL,COL,162,67,95,740,862,-122,0.413580247
2005,AL,DET,162,71,91,723,787,-64,0.438271605
2005,NL,FLO,162,83,79,717,732,-15,0.512345679
2005,NL,HOU,163,89,73,693,609,84,0.549382716
2005,AL,KCA,162,56,106,701,935,-234,0.345679012
2005,AL,LAA,162,95,67,761,643,118,0.586419753
2005,NL,LAN,162,71,91,685,755,-70,0.438271605
2005,NL,MIL,162,81,81,726,697,29,0.5
2005,AL,MIN,162,83,79,688,662,26,0.512345679
2005,AL,NYA,162,95,67,886,789,97,0.586419753
2005,NL,NYN,162,83,79,722,648,74,0.512345679
2005,AL,OAK,162,88,74,772,658,114,0.543209877
2005,NL,PHI,162,88,74,807,726,81,0.543209877
2005,NL,PIT,162,67,95,680,769,-89,0.413580247
2005,NL,SDN,162,82,80,684,726,-42,0.50617284
2005,AL,SEA,162,69,93,699,751,-52,0.425925926
2005,NL,SFN,162,75,87,649,745,-96,0.462962963
2005,NL,SLN,162,100,62,805,634,171,0.617283951
2005,AL,TBA,162,67,95,750,936,-186,0.413580247
2005,AL,TEX,162,79,83,865,858,7,0.487654321
2005,AL,TOR,162,80,82,775,705,70,0.49382716
2005,NL,WAS,162,81,81,639,673,-34,0.5
2006,NL,ARI,162,76,86,773,788,-15,0.469135802
2006,NL,ATL,162,79,83,849,805,44,0.487654321
2006,AL,BAL,162,70,92,768,899,-131,0.432098765
2006,AL,BOS,162,86,76,820,825,-5,0.530864198
2006,AL,CHA,162,90,72,868,794,74,0.555555556
2006,NL,CHN,162,66,96,716,834,-118,0.407407407
2006,NL,CIN,162,80,82,749,801,-52,0.49382716
2006,AL,CLE,162,78,84,870,782,88,0.481481481
2006,NL,COL,162,76,86,813,812,1,0.469135802
2006,AL,DET,162,95,67,822,675,147,0.586419753
2006,NL,FLO,162,78,84,758,772,-14,0.481481481
2006,NL,HOU,162,82,80,735,719,16,0.50617284
2006,AL,KCA,162,62,100,757,971,-214,0.382716049
2006,AL,LAA,162,89,73,766,732,34,0.549382716
2006,NL,LAN,162,88,74,820,751,69,0.543209877
2006,NL,MIL,162,75,87,730,833,-103,0.462962963
2006,AL,MIN,162,96,66,801,683,118,0.592592593
2006,AL,NYA,162,97,65,930,767,163,0.598765432
2006,NL,NYN,162,97,65,834,731,103,0.598765432
2006,AL,OAK,162,93,69,771,727,44,0.574074074
2006,NL,PHI,162,85,77,865,812,53,0.524691358
2006,NL,PIT,162,67,95,691,797,-106,0.413580247
2006,NL,SDN,162,88,74,731,679,52,0.543209877
2006,AL,SEA,162,78,84,756,792,-36,0.481481481
2006,NL,SFN,161,76,85,746,790,-44,0.472049689
2006,NL,SLN,161,83,78,781,762,19,0.51552795
2006,AL,TBA,162,61,101,689,856,-167,0.37654321
2006,AL,TEX,162,80,82,835,784,51,0.49382716
2006,AL,TOR,162,87,75,809,754,55,0.537037037
2006,NL,WAS,162,71,91,746,872,-126,0.438271605
2007,NL,ARI,162,90,72,712,732,-20,0.555555556
2007,NL,ATL,162,84,78,810,733,77,0.518518519
2007,AL,BAL,162,69,93,756,868,-112,0.425925926
2007,AL,BOS,162,96,66,867,657,210,0.592592593
2007,AL,CHA,162,72,90,693,839,-146,0.444444444
2007,NL,CHN,162,85,77,752,690,62,0.524691358
2007,NL,CIN,162,72,90,783,853,-70,0.444444444
2007,AL,CLE,162,96,66,811,704,107,0.592592593
2007,NL,COL,163,90,73,860,758,102,0.552147239
2007,AL,DET,162,88,74,887,797,90,0.543209877
2007,NL,FLO,162,71,91,790,891,-101,0.438271605
2007,NL,HOU,162,73,89,723,813,-90,0.450617284
2007,AL,KCA,162,69,93,706,778,-72,0.425925926
2007,AL,LAA,162,94,68,822,731,91,0.580246914
2007,NL,LAN,162,82,80,735,727,8,0.50617284
2007,NL,MIL,162,83,79,801,776,25,0.512345679
2007,AL,MIN,162,79,83,718,725,-7,0.487654321
2007,AL,NYA,162,94,68,968,777,191,0.580246914
2007,NL,NYN,162,88,74,804,750,54,0.543209877
2007,AL,OAK,162,76,86,741,758,-17,0.469135802
2007,NL,PHI,162,89,73,892,821,71,0.549382716
2007,NL,PIT,162,68,94,724,846,-122,0.419753086
2007,NL,SDN,163,89,74,741,666,75,0.54601227
2007,AL,SEA,162,88,74,794,813,-19,0.543209877
2007,NL,SFN,162,71,91,683,720,-37,0.438271605
2007,NL,SLN,162,78,84,725,829,-104,0.481481481
2007,AL,TBA,162,66,96,782,944,-162,0.407407407
2007,AL,TEX,162,75,87,816,844,-28,0.462962963
2007,AL,TOR,162,83,79,753,699,54,0.512345679
2007,NL,WAS,162,73,89,673,783,-110,0.450617284
2008,NL,ARI,162,82,80,720,706,14,0.50617284
2008,NL,ATL,162,72,90,753,778,-25,0.444444444
2008,AL,BAL,161,68,93,782,869,-87,0.422360248
2008,AL,BOS,162,95,67,845,694,151,0.586419753
2008,AL,CHA,163,89,74,811,729,82,0.54601227
2008,NL,CHN,161,97,64,855,671,184,0.602484472
2008,NL,CIN,162,74,88,704,800,-96,0.456790123
2008,AL,CLE,162,81,81,805,761,44,0.5
2008,NL,COL,162,74,88,747,822,-75,0.456790123
2008,AL,DET,162,74,88,821,857,-36,0.456790123
2008,NL,FLO,161,84,77,770,767,3,0.52173913
2008,NL,HOU,161,86,75,712,743,-31,0.534161491
2008,AL,KCA,162,75,87,691,781,-90,0.462962963
2008,AL,LAA,162,100,62,765,697,68,0.617283951
2008,NL,LAN,162,84,78,700,648,52,0.518518519
2008,NL,MIL,162,90,72,750,689,61,0.555555556
2008,AL,MIN,163,88,75,829,745,84,0.539877301
2008,AL,NYA,162,89,73,789,727,62,0.549382716
2008,NL,NYN,162,89,73,799,715,84,0.549382716
2008,AL,OAK,161,75,86,646,690,-44,0.465838509
2008,NL,PHI,162,92,70,799,680,119,0.567901235
2008,NL,PIT,162,67,95,735,884,-149,0.413580247
2008,NL,SDN,162,63,99,637,764,-127,0.388888889
2008,AL,SEA,162,61,101,671,811,-140,0.37654321
2008,NL,SFN,162,72,90,640,759,-119,0.444444444
2008,NL,SLN,162,86,76,779,725,54,0.530864198
2008,AL,TBA,162,97,65,774,671,103,0.598765432
2008,AL,TEX,162,79,83,901,967,-66,0.487654321
2008,AL,TOR,162,86,76,714,610,104,0.530864198
2008,NL,WAS,161,59,102,641,825,-184,0.366459627
2009,NL,ARI,162,70,92,720,782,-62,0.432098765
2009,NL,ATL,162,86,76,735,641,94,0.530864198
2009,AL,BAL,162,64,98,741,876,-135,0.395061728
2009,AL,BOS,162,95,67,872,736,136,0.586419753
2009,AL,CHA,162,79,83,724,732,-8,0.487654321
2009,NL,CHN,161,83,78,707,672,35,0.51552795
2009,NL,CIN,162,78,84,673,723,-50,0.481481481
2009,AL,CLE,162,65,97,773,865,-92,0.401234568
2009,NL,COL,162,92,70,804,715,89,0.567901235
2009,AL,DET,163,86,77,743,745,-2,0.527607362
2009,NL,FLO,162,87,75,772,766,6,0.537037037
2009,NL,HOU,162,74,88,643,770,-127,0.456790123
2009,AL,KCA,162,65,97,686,842,-156,0.401234568
2009,AL,LAA,162,97,65,883,761,122,0.598765432
2009,NL,LAN,162,95,67,780,611,169,0.586419753
2009,NL,MIL,162,80,82,785,818,-33,0.49382716
2009,AL,MIN,163,87,76,817,765,52,0.533742331
2009,AL,NYA,162,103,59,915,753,162,0.635802469
2009,NL,NYN,162,70,92,671,757,-86,0.432098765
2009,AL,OAK,162,75,87,759,761,-2,0.462962963
2009,NL,PHI,162,93,69,820,709,111,0.574074074
2009,NL,PIT,161,62,99,636,768,-132,0.385093168
2009,NL,SDN,162,75,87,638,769,-131,0.462962963
2009,AL,SEA,162,85,77,640,692,-52,0.524691358
2009,NL,SFN,162,88,74,657,611,46,0.543209877
2009,NL,SLN,162,91,71,730,640,90,0.561728395
2009,AL,TBA,162,84,78,803,754,49,0.518518519
2009,AL,TEX,162,87,75,784,740,44,0.537037037
2009,AL,TOR,162,75,87,798,771,27,0.462962963
2009,NL,WAS,162,59,103,710,874,-164,0.364197531
2010,NL,ARI,162,65,97,713,836,-123,0.401234568
2010,NL,ATL,162,91,71,738,629,109,0.561728395
2010,AL,BAL,162,66,96,613,785,-172,0.407407407
2010,AL,BOS,162,89,73,818,744,74,0.549382716
2010,AL,CHA,162,88,74,752,704,48,0.543209877
2010,NL,CHN,162,75,87,685,767,-82,0.462962963
2010,NL,CIN,162,91,71,790,685,105,0.561728395
2010,AL,CLE,162,69,93,646,752,-106,0.425925926
2010,NL,COL,162,83,79,770,717,53,0.512345679
2010,AL,DET,162,81,81,751,743,8,0.5
2010,NL,FLO,162,80,82,719,717,2,0.49382716
2010,NL,HOU,162,76,86,611,729,-118,0.469135802
2010,AL,KCA,162,67,95,676,845,-169,0.413580247
2010,AL,LAA,162,80,82,681,702,-21,0.49382716
2010,NL,LAN,162,80,82,667,692,-25,0.49382716
2010,NL,MIL,162,77,85,750,804,-54,0.475308642
2010,AL,MIN,162,94,68,781,671,110,0.580246914
2010,AL,NYA,162,95,67,859,693,166,0.586419753
2010,NL,NYN,162,79,83,656,652,4,0.487654321
2010,AL,OAK,162,81,81,663,626,37,0.5
2010,NL,PHI,162,97,65,772,640,132,0.598765432
2010,NL,PIT,162,57,105,587,866,-279,0.351851852
2010,NL,SDN,162,90,72,665,581,84,0.555555556
2010,AL,SEA,162,61,101,513,698,-185,0.37654321
2010,NL,SFN,162,92,70,697,583,114,0.567901235
2010,NL,SLN,162,86,76,736,641,95,0.530864198
2010,AL,TBA,162,96,66,802,649,153,0.592592593
2010,AL,TEX,162,90,72,787,687,100,0.555555556
2010,AL,TOR,162,85,77,755,728,27,0.524691358
2010,NL,WAS,162,69,93,655,742,-87,0.425925926
2011,NL,ARI,162,94,68,731,662,69,0.580246914
2011,NL,ATL,162,89,73,641,605,36,0.549382716
2011,AL,BAL,162,69,93,708,860,-152,0.425925926
2011,AL,BOS,162,90,72,875,737,138,0.555555556
2011,AL,CHA,162,79,83,654,706,-52,0.487654321
2011,NL,CHN,162,71,91,654,756,-102,0.438271605
2011,NL,CIN,162,79,83,735,720,15,0.487654321
2011,AL,CLE,162,80,82,704,760,-56,0.49382716
2011,NL,COL,162,73,89,735,774,-39,0.450617284
2011,AL,DET,162,95,67,787,711,76,0.586419753
2011,NL,FLO,162,72,90,625,702,-77,0.444444444
2011,NL,HOU,162,56,106,615,796,-181,0.345679012
2011,AL,KCA,162,71,91,730,762,-32,0.438271605
2011,AL,LAA,162,86,76,667,633,34,0.530864198
2011,NL,LAN,161,82,79,644,612,32,0.50931677
2011,NL,MIL,162,96,66,721,638,83,0.592592593
2011,AL,MIN,162,63,99,619,804,-185,0.388888889
2011,AL,NYA,162,97,65,867,657,210,0.598765432
2011,NL,NYN,162,77,85,718,742,-24,0.475308642
2011,AL,OAK,162,74,88,645,679,-34,0.456790123
2011,NL,PHI,162,102,60,713,529,184,0.62962963
2011,NL,PIT,162,72,90,610,712,-102,0.444444444
2011,NL,SDN,162,71,91,593,611,-18,0.438271605
2011,AL,SEA,162,67,95,556,675,-119,0.413580247
2011,NL,SFN,162,86,76,570,578,-8,0.530864198
2011,NL,SLN,162,90,72,762,692,70,0.555555556
2011,AL,TBA,162,91,71,707,614,93,0.561728395
2011,AL,TEX,162,96,66,855,677,178,0.592592593
2011,AL,TOR,162,81,81,743,761,-18,0.5
2011,NL,WAS,161,80,81,624,643,-19,0.49689441
2012,NL,ARI,162,81,81,734,688,46,0.5
2012,NL,ATL,162,94,68,700,600,100,0.580246914
2012,AL,BAL,162,93,69,712,705,7,0.574074074
2012,AL,BOS,162,69,93,734,806,-72,0.425925926
2012,AL,CHA,162,85,77,748,676,72,0.524691358
2012,NL,CHN,162,61,101,613,759,-146,0.37654321
2012,NL,CIN,162,97,65,669,588,81,0.598765432
2012,AL,CLE,162,68,94,667,845,-178,0.419753086
2012,NL,COL,162,64,98,758,890,-132,0.395061728
2012,AL,DET,162,88,74,726,670,56,0.543209877
2012,NL,HOU,162,55,107,583,794,-211,0.339506173
2012,AL,KCA,162,72,90,676,746,-70,0.444444444
2012,AL,LAA,162,89,73,767,699,68,0.549382716
2012,NL,LAN,162,86,76,637,597,40,0.530864198
2012,NL,MIA,162,69,93,609,724,-115,0.425925926
2012,NL,MIL,162,83,79,776,733,43,0.512345679
2012,AL,MIN,162,66,96,701,832,-131,0.407407407
2012,AL,NYA,162,95,67,804,668,136,0.586419753
2012,NL,NYN,162,74,88,650,709,-59,0.456790123
2012,AL,OAK,162,94,68,713,614,99,0.580246914
2012,NL,PHI,162,81,81,684,680,4,0.5
2012,NL,PIT,162,79,83,651,674,-23,0.487654321
2012,NL,SDN,162,76,86,651,710,-59,0.469135802
2012,AL,SEA,162,75,87,619,651,-32,0.462962963
2012,NL,SFN,162,94,68,718,649,69,0.580246914
2012,NL,SLN,162,88,74,765,648,117,0.543209877
2012,AL,TBA,162,90,72,697,577,120,0.555555556
2012,AL,TEX,162,93,69,808,707,101,0.574074074
2012,AL,TOR,162,73,89,716,784,-68,0.450617284
2012,NL,WAS,162,98,64,731,594,137,0.604938272
2013,NL,ARI,162,81,81,685,695,-10,0.5
2013,NL,ATL,162,96,66,688,548,140,0.592592593
2013,AL,BAL,162,85,77,745,709,36,0.524691358
2013,AL,BOS,162,97,65,853,656,197,0.598765432
2013,AL,CHA,162,63,99,598,723,-125,0.388888889
2013,NL,CHN,162,66,96,602,689,-87,0.407407407
2013,NL,CIN,162,90,72,698,589,109,0.555555556
2013,AL,CLE,162,92,70,745,662,83,0.567901235
2013,NL,COL,162,74,88,706,760,-54,0.456790123
2013,AL,DET,162,93,69,796,624,172,0.574074074
2013,AL,HOU,162,51,111,610,848,-238,0.314814815
2013,AL,KCA,162,86,76,648,601,47,0.530864198
2013,AL,LAA,162,78,84,733,737,-4,0.481481481
2013,NL,LAN,162,92,70,649,582,67,0.567901235
2013,NL,MIA,162,62,100,513,646,-133,0.382716049
2013,NL,MIL,162,74,88,640,687,-47,0.456790123
2013,AL,MIN,162,66,96,614,788,-174,0.407407407
2013,AL,NYA,162,85,77,650,671,-21,0.524691358
2013,NL,NYN,162,74,88,619,684,-65,0.456790123
2013,AL,OAK,162,96,66,767,625,142,0.592592593
2013,NL,PHI,162,73,89,610,749,-139,0.450617284
2013,NL,PIT,162,94,68,634,577,57,0.580246914
2013,NL,SDN,162,76,86,618,700,-82,0.469135802
2013,AL,SEA,162,71,91,624,754,-130,0.438271605
2013,NL,SFN,162,76,86,629,691,-62,0.469135802
2013,NL,SLN,162,97,65,783,596,187,0.598765432
2013,AL,TBA,163,92,71,700,646,54,0.564417178
2013,AL,TEX,163,91,72,730,636,94,0.558282209
2013,AL,TOR,162,74,88,712,756,-44,0.456790123
2013,NL,WAS,162,86,76,656,626,30,0.530864198
2014,NL,ARI,162,64,98,615,742,-127,0.395061728
2014,NL,ATL,162,79,83,573,597,-24,0.487654321
2014,AL,BAL,162,96,66,705,593,112,0.592592593
2014,AL,BOS,162,71,91,634,715,-81,0.438271605
2014,AL,CHA,162,73,89,660,758,-98,0.450617284
2014,NL,CHN,162,73,89,614,707,-93,0.450617284
2014,NL,CIN,162,76,86,595,612,-17,0.469135802
2014,AL,CLE,162,85,77,669,653,16,0.524691358
2014,NL,COL,162,66,96,755,818,-63,0.407407407
2014,AL,DET,162,90,72,757,705,52,0.555555556
2014,AL,HOU,162,70,92,629,723,-94,0.432098765
2014,AL,KCA,162,89,73,651,624,27,0.549382716
2014,AL,LAA,162,98,64,773,630,143,0.604938272
2014,NL,LAN,162,94,68,718,617,101,0.580246914
2014,NL,MIA,162,77,85,645,674,-29,0.475308642
2014,NL,MIL,162,82,80,650,657,-7,0.50617284
2014,AL,MIN,162,70,92,715,777,-62,0.432098765
2014,AL,NYA,162,84,78,633,664,-31,0.518518519
2014,NL,NYN,162,79,83,629,618,11,0.487654321
2014,AL,OAK,162,88,74,729,572,157,0.543209877
2014,NL,PHI,162,73,89,619,687,-68,0.450617284
2014,NL,PIT,162,88,74,682,631,51,0.543209877
2014,NL,SDN,162,77,85,535,577,-42,0.475308642
2014,AL,SEA,162,87,75,634,554,80,0.537037037
2014,NL,SFN,162,88,74,665,614,51,0.543209877
2014,NL,SLN,162,90,72,619,603,16,0.555555556
2014,AL,TBA,162,77,85,612,625,-13,0.475308642
2014,AL,TEX,162,67,95,637,773,-136,0.413580247
2014,AL,TOR,162,83,79,723,686,37,0.512345679
2014,NL,WAS,162,96,66,686,555,131,0.592592593
2015,NL,ARI,162,79,83,720,713,7,0.487654321
2015,NL,ATL,162,67,95,573,760,-187,0.413580247
2015,AL,BAL,162,81,81,713,693,20,0.5
2015,AL,BOS,162,78,84,748,753,-5,0.481481481
2015,AL,CHA,162,76,86,622,701,-79,0.469135802
2015,NL,CHN,162,97,65,689,608,81,0.598765432
2015,NL,CIN,162,64,98,640,754,-114,0.395061728
2015,AL,CLE,161,81,80,669,640,29,0.50310559
2015,NL,COL,162,68,94,737,844,-107,0.419753086
2015,AL,DET,161,74,87,689,803,-114,0.459627329
2015,AL,HOU,162,86,76,729,618,111,0.530864198
2015,AL,KCA,162,95,67,724,641,83,0.586419753
2015,AL,LAA,162,85,77,661,675,-14,0.524691358
2015,NL,LAN,162,92,70,667,595,72,0.567901235
2015,NL,MIA,162,71,91,613,678,-65,0.438271605
2015,NL,MIL,162,68,94,655,737,-82,0.419753086
2015,AL,MIN,162,83,79,696,700,-4,0.512345679
2015,AL,NYA,162,87,75,764,698,66,0.537037037
2015,NL,NYN,162,90,72,683,613,70,0.555555556
2015,AL,OAK,162,68,94,694,729,-35,0.419753086
2015,NL,PHI,162,63,99,626,809,-183,0.388888889
2015,NL,PIT,162,98,64,697,596,101,0.604938272
2015,NL,SDN,162,74,88,650,731,-81,0.456790123
2015,AL,SEA,162,76,86,656,726,-70,0.469135802
2015,NL,SFN,162,84,78,696,627,69,0.518518519
2015,NL,SLN,162,100,62,647,525,122,0.617283951
2015,AL,TBA,162,80,82,644,642,2,0.49382716
2015,AL,TEX,162,88,74,751,733,18,0.543209877
2015,AL,TOR,162,93,69,891,670,221,0.574074074
2015,NL,WAS,162,83,79,703,635,68,0.512345679
2016,NL,ARI,162,69,93,752,890,-138,0.425925926
2016,NL,ATL,161,68,93,649,779,-130,0.422360248
2016,AL,BAL,162,89,73,744,715,29,0.549382716
2016,AL,BOS,162,93,69,878,694,184,0.574074074
2016,AL,CHA,162,78,84,686,715,-29,0.481481481
2016,NL,CHN,162,103,58,808,556,252,0.639751553
2016,NL,CIN,162,68,94,716,854,-138,0.419753086
2016,AL,CLE,161,94,67,777,676,101,0.583850932
2016,NL,COL,162,75,87,845,860,-15,0.462962963
2016,AL,DET,161,86,75,750,721,29,0.534161491
2016,AL,HOU,162,84,78,724,701,23,0.518518519
2016,AL,KCA,162,81,81,675,712,-37,0.5
2016,AL,LAA,162,74,88,717,727,-10,0.456790123
2016,NL,LAN,162,91,71,725,638,87,0.561728395
2016,NL,MIA,161,79,82,655,682,-27,0.49068323
2016,NL,MIL,162,73,89,671,733,-62,0.450617284
2016,AL,MIN,162,59,103,722,889,-167,0.364197531
2016,AL,NYA,162,84,78,680,702,-22,0.518518519
2016,NL,NYN,162,87,75,671,617,54,0.537037037
2016,AL,OAK,162,69,93,653,761,-108,0.425925926
2016,NL,PHI,162,71,91,610,796,-186,0.438271605
2016,NL,PIT,162,78,83,729,758,-29,0.48447205
2016,NL,SDN,162,68,94,686,770,-84,0.419753086
2016,AL,SEA,162,86,76,768,707,61,0.530864198
2016,NL,SFN,162,87,75,715,631,84,0.537037037
2016,NL,SLN,162,86,76,779,712,67,0.530864198
2016,AL,TBA,162,68,94,672,713,-41,0.419753086
2016,AL,TEX,162,95,67,765,757,8,0.586419753
2016,AL,TOR,162,89,73,759,666,93,0.549382716
2016,NL,WAS,162,95,67,763,612,151,0.586419753
2017,NL,ARI,162,93,69,812,659,153,0.574074074
2017,NL,ATL,162,72,90,732,821,-89,0.444444444
2017,AL,BAL,162,75,87,743,841,-98,0.462962963
2017,AL,BOS,162,93,69,785,668,117,0.574074074
2017,AL,CHA,162,67,95,706,820,-114,0.413580247
2017,NL,CHN,162,92,70,822,695,127,0.567901235
2017,NL,CIN,162,68,94,753,869,-116,0.419753086
2017,AL,CLE,162,102,60,818,564,254,0.62962963
2017,NL,COL,162,87,75,824,757,67,0.537037037
2017,AL,DET,162,64,98,735,894,-159,0.395061728
2017,AL,HOU,162,101,61,896,700,196,0.62345679
2017,AL,KCA,162,80,82,702,791,-89,0.49382716
2017,AL,LAA,162,80,82,710,709,1,0.49382716
2017,NL,LAN,162,104,58,770,580,190,0.641975309
2017,NL,MIA,162,77,85,778,822,-44,0.475308642
2017,NL,MIL,162,86,76,732,697,35,0.530864198
2017,AL,MIN,162,85,77,815,788,27,0.524691358
2017,AL,NYA,162,91,71,858,660,198,0.561728395
2017,NL,NYN,162,70,92,735,863,-128,0.432098765
2017,AL,OAK,162,75,87,739,826,-87,0.462962963
2017,NL,PHI,162,66,96,690,782,-92,0.407407407
2017,NL,PIT,162,75,87,668,731,-63,0.462962963
2017,NL,SDN,162,71,91,604,816,-212,0.438271605
2017,AL,SEA,162,78,84,750,772,-22,0.481481481
2017,NL,SFN,162,64,98,639,776,-137,0.395061728
2017,NL,SLN,162,83,79,761,705,56,0.512345679
2017,AL,TBA,162,80,82,694,704,-10,0.49382716
2017,AL,TEX,162,78,84,799,816,-17,0.481481481
2017,AL,TOR,162,76,86,693,784,-91,0.469135802
2017,NL,WAS,162,97,65,819,672,147,0.598765432